11,12,,,,,,,,,,,,,,,

*,*,*,*,*,*,*,*,*,*,*
*,c,c,c,c,c,c,c,c,c,*
*,c,*,*,*,*,*,*,*,c,*
*,c,c,c,c,p,c,c,c,c,*
*,c,*,c,*,s,*,c,*,c,*
*,c,*,c,*,c,*,c,*,c,*
*,c,c,c,*,c,*,c,c,c,*
*,*,*,c,*,t,*,c,*,c,*
*,c,c,c,*,c,*,c,c,c,*
*,c,*,*,*,c,*,*,*,c,*
*,c,c,c,c,c,c,c,c,1,*
*,*,*,*,*,*,*,*,*,*,*

